0 45 0 50 0 55 0 60 0 65 0 0
1 2 3 4 5 6 7 8 9 10 11 0
0 46 0 51 0 56 0 61 0 66 0 0
12 13 14 15 16 17 18 19 20 21 22 0
0 47 0 52 0 57 0 62 0 67 0 0
23 24 25 26 27 28 29 30 31 32 33 0
0 48 0 53 0 58 0 63 0 68 0 0
34 35 36 37 38 39 40 41 42 43 44 0 0
0 49 0 54 0 59 0 64 0 69 0 0
