1 2 3 4 5 6 7 8 9 10 11 12
38 0 0 0 0 0 0 0 0 0 0 13
37 0 0 0 0 0 0 0 0 0 0 14
36 0 0 0 0 0 0 0 0 0 0 15
35 0 0 0 0 0 0 0 0 0 0 16
34 0 0 0 0 0 0 0 0 0 0 17
33 0 0 0 0 0 0 0 0 0 0 18
32 0 0 0 0 0 0 0 0 0 0 19
31 30 29 28 27 26 25 24 23 22 21 20
