1 58 57 56 55 0 0 20 19 18 17 16
2 0 0 0 54 0 0 21 0 0 0 15
3 4 5 6 7 8 9 10 11 12 13 14
0 0 0 0 53 0 0 22 0 0 0 0
0 0 0 0 52 0 0 23 0 0 0 0
0 0 0 0 51 0 0 24 0 0 0 0
43 42 41 40 39 38 37 25 36 35 34 33
44 0 0 0 50 0 0 26 0 0 0 32
45 46 47 48 49 0 0 27 28 29 30 31
