0 0 0 0 0 9 10 0 0 0 0 0
0 0 0 0 0 8 11 0 0 0 0 0
0 0 0 0 0 7 12 0 0 0 0 0
1 2 3 4 5 6 13 14 15 16 17 18
38 0 0 0 0 0 0 0 0 0 0 19
37 36 35 34 33 32 25 24 23 22 21 20
0 0 0 0 0 31 26 0 0 0 0 0
0 0 0 0 0 30 27 0 0 0 0 0
0 0 0 0 0 29 28 0 0 0 0 0
