1 0 19 20 21 0 39 40 41 0 59 60
2 0 18 0 22 0 38 0 42 0 58 0
3 0 17 0 23 0 37 0 43 0 57 0
4 0 16 0 24 0 36 0 44 0 56 0
5 0 15 0 25 0 35 0 45 0 55 0
6 0 14 0 26 0 34 0 46 0 54 0
7 0 13 0 27 0 33 0 47 0 52 0
8 0 12 0 28 0 32 0 48 0 52 0
9 10 11 0 29 30 31 0 49 50 51 0
